2018 Mazda CX-5 KF4W2A Maxx SKYACTIV-Drive i-ACTIV AWD Sport Black 6 Speed Sports Automatic Wagon
Vehicle	2018 Mazda CX-5 KF4W2A Maxx SKYACTIV-Drive i-ACTIV AWD Sport Black 6 Speed Sports Automatic Wagon
Body Colour	Black
Engine  2.2L 4Cyl
Price   30990
Doors	5
Seats	5
Cylinders	4
Fuel Type	Diesel
Capacity	2.2
Gears	6 Speed
Gearbox	Sports Automatic
Transmission	Automatic
Odometer	133,154 kms
Drive Type	4WD
Rego	1NE8PI
StockNo	00005246
VIN	JM0KF4W2A00212050
Fuel Consumption (Urban)	6.5L/100km
Fuel Consumption (Extra Urban)	5.2L/100km
Fuel Consumption (Combined)	5.7L/100km
Towing Weight Braked	1800kg

Central Locking - Remote/Keyless	Cruise Control
17" Alloy Wheels	Power Steering - Electric Assist
Air Cond. - Climate Control 2 Zone	ABS (Antilock Brakes)
Airbag - Driver	Airbag - Passenger
Airbags - Head for 1st Row Seats (Front)	Airbags - Head for 2nd Row Seats
Airbags - Side for 1st Row Occupants (Front)	Audio - Aux Input Socket (MP3/CD/Cassette)
Central Locking - Once Mobile	Central Locking - Remote/Keyless
GPS (Satellite Navigation)	Power Door Mirrors - Folding
Power Windows - Front & Rear	6 Speaker Stereo
Control - Traction	12V Socket(s) - Auxiliary
Adjustable Steering Col. - Tilt & Reach	Armrest - Front Centre (Shared)
Armrest - Rear Centre (Shared)	Audio - Aux Input USB Socket
Audio - Input for iPod	Blind Spot Sensor
Bluetooth System	Body Colour - Bumpers
Body Colour - Door Handles	Body Colour - Exterior Mirrors Partial
Bottle Holders - 1st Row	Bottle Holders - 2nd Row
Brake Assist	Brake Emergency Display - Hazard/Stoplights
Camera - Rear Vision	Cargo Cover
Chrome Exhaust Tip(s)	Collision Mitigation - Forward (Low speed)
Collision Mitigation - Reversing	Collision Warning - Forward
Collision Warning - Rearward	Control - Electronic Stability
Control - Park Distance Rear	Control - Pedestrian Avoidance with Braking
Cup Holders - 1st Row	Disc Brakes Front Ventilated
Disc Brakes Rear Solid	Drive By Wire (Electronic Throttle Control)
EBD (Electronic Brake Force Distribution)	Engine - Stop Start System (When at idle)
Engine Immobiliser	Fog Lamps - Front LED
Headlamps - LED	Headlamps Automatic (light sensitive)
Headrests - Adjustable 1st Row (Front)	Headrests - Adjustable 2nd Row x3
Hill Holder	Illuminated - Entry/Exit with Fade
Illuminated - Switch Panel (Window/ Locking)	Keyless Start - Key/FOB Proximity related
Leather Gear Knob	Leather Steering Wheel
Map/Reading Lamps - for 1st Row	Multi-function Control Screen - Colour
Multi-function Steering Wheel	Park Brake - Electric
Parking Assist - Graphical Display	Radio - Digital (DAB+)
Rain Sensor (Auto wipers)	Rear View Mirror - Electric Anti Glare
Rear Wiper/Washer	Remote Fuel Lid Release
Seat - Height Adjustable Driver	Seat - Height Adjustable Passenger
Seatback Pockets - 1st Row (Front) seats	Seatbelt - Adjustable Height 1st Row
Seatbelt - Load Limiters 1st Row (Front)	Seatbelt - Pretensioners 1st Row (Front)
Seatbelts - Lap/Sash for 5 seats	Seats - 2nd Row Reclining
Seats - 2nd Row Split Fold	Smart Device App Display/Control
Spare Wheel - Space Saver/Temporary	Speed Limiter
Spoiler - Rear Roof Mounted	Starter Button
Storage Compartment - Centre Console 1st Row	Sunglass Holder
Sunvisor - Illuminated Vanity Mirrors Dual	Tacho
Tail Lamps - LED	Trim - Cloth
Trip Computer	Warning - Rear Cross Traffic (when reversing)
Log books	Power windows
Power Steering	Airbag
Anti-lock Braking System (ABS)	Central Locking
Air Conditioning	Traction control system
Power mirrors	Alloy Wheels
Climate Control	 

Description:
This luxurious 2018 SUV has the Mazda reliability - and with all the modern features you can name.